XXXXXXXXXXXXXXXXXXXXXXXXXXXXXXXX
XXXXXXXXXXXXXXXXXXXXXXXXXXXXXXXX
XXXXXXXXXXXXXXXXXXXXXXXXXXXXXXXX
XXXXXXXXXXXXXXXXXXXXXXXXXXXXXXXX
XXXXXXXXXXXXXXXXXXXXXXXXXXXXXXXX
XXXXXXXXXXXXXXXXXXXXXXXXXXXXXXXX
XXXXXXXOOOOOXXOOOOOXXXOOOOOXXXXX
XXXXXXOOOOOOOOOOOOOOOOOOOOOOOXXX
XXXXXOOOOOOOOOOOOOOOOOOOOOOOOOXX
XXXXOOOOOOOOOOOOOOOOOOOOOOOOOOXX
XXXOOOOOOOOOOOOOOOOOOOOOOOOOOOOX
XXXOOOOOOOOOOOOOOOOOOOOOOOOOOOOX
XXXOOOOWOOOOOOOOOOOOOOOOOCOOOOOX
XXXOOOOOOOOOOOOOOOOOOOOOOOOOOOOX
XXXXOSOOOOOOOOOOOOOOOOOOOKOOOOXX
XXXXOOOOOOOOOOOOOOOOOOOOOOOOOOXX
XXXXXOOWOOOOOOOOOOOOOOOCOOOOOXXX
XXXXXXXOOOOOXXOOOOOXXXOOOOOXXXXX
XXXXXXXXXXXXXXXXXXXXXXXXXXXXXXXX
XXXXXXXXXXXXXXXXXXXXXXXXXXXXXXXX
XXXXXXXXXXXXXXXXXXXXXXXXXXXXXXXX
XXXXXXXXXXXXXXXXXXXXXXXXXXXXXXXX
XXXXXXXXXXXXXXXXXXXXXXXXXXXXXXXX
XXXXXXXXXXXXXXXXXXXXXXXXXXXXXXXX