XXXXXXXXXXXXXXXXXXXXXXXXXXXXXXXX
XXXXXXXXXXXXXXXXXXXXXXXXXXXXXXXX
XXXXXXXXXXXXXXXXXXXXXXXXXXXXXXXX
XXXXXXXXXXXXXXXXXXXXXXXXXXXXXXXX
XXXXXXXXXXXXXXXXXXXXXXXXXXXXXXXX
XXXXXXXXXXXXXXXXXXXXXXXXXXXXXXXX
XXXXXXXOOOOOXXOOOOOXXXOOOOOXXXXX
XXXXXXOOOOOOOOOOOOOOOOOOOOOOOXXX
XXXXXOOOOOOOOOOOOOOOOOOOOOOOOOXX
XXXXOOOOOOOOOOOOOOOOOOOOOOOOOOXX
XXXOOOOOOOOOPOOOOOPOOOOOOOOOOOOX
XXXOOOOOOOOOOOOOOOOOOOOOOOOOOOOX
XXXOOOOOOOOOOOOOPOOOOOOOOOOOOOOX
XXXOOOOOOOOOOOOOOOPOOOOOOOOOOOOX
XXXXOOOOOOOPOOOOOOOOOOOOOOOOOOXX
XXXXOOOOOOOOOOOOOOOOOOOOOOOOOOXX
XXXXXOOOOOOOOOOOOOOOOOOOOOOOOXXX
XXXXXXXOOOOOXXOOOOOXXXOOOOOXXXXX
XXXXXXXXXXXXXXXXXXXXXXXXXXXXXXXX
XXXXXXXXXXXXXXXXXXXXXXXXXXXXXXXX
XXXXXXXXXXXXXXXXXXXXXXXXXXXXXXXX
XXXXXXXXXXXXXXXXXXXXXXXXXXXXXXXX
XXXXXXXXXXXXXXXXXXXXXXXXXXXXXXXX
XXXXXXXXXXXXXXXXXXXXXXXXXXXXXXXX